 6 6 6 6 6 6 6 6 6 6 6 6 6 6 6 6 
 6 0 0 0 0 0 0 0 0 0 0 0 0 0 0 6 
 6 0 9 0 0 0 0 0 0 0 0 0 0 0 0 6 
 6 0 0 0 0 6 0 0 7 7 7 0 0 7 0 6 
 6 0 0 0 0 8 0 0 7 0 0 0 0 9 0 6 
 6 0 0 0 0 8 0 0 7 0 0 0 0 7 0 6 
 6 6 6 6 6 6 0 0 7 0 0 7 7 7 0 6 
 6 0 0 0 0 0 0 0 0 0 0 0 0 0 0 6 
 6 0 0 0 0 0 0 0 0 0 0 0 0 0 0 6 
 6 0 7 9 7 0 0 6 6 6 0 0 7 9 7 6 
 6 0 0 0 0 0 0 6 6 6 0 0 0 0 0 6 
 6 0 0 0 0 0 0 6 6 8 0 0 0 0 0 6 
 6 0 0 0 0 0 0 6 6 8 0 0 0 0 0 6 
 6 0 0 0 0 0 0 6 6 6 0 0 0 0 0 6 
 6 0 0 0 6 8 8 6 6 6 6 6 0 0 0 6 
 6 0 0 0 0 0 6 6 6 6 6 6 0 0 0 6 
 6 0 0 0 0 0 0 6 6 0 0 0 0 0 0 6 
 6 0 0 0 0 0 0 0 0 0 0 0 0 0 0 6 
 6 8 8 6 0 0 0 0 0 0 0 0 0 0 0 6 
 6 6 6 6 0 0 0 0 0 0 0 0 0 0 0 6 
 6 6 6 6 0 0 0 7 7 7 7 7 0 0 0 6 
 6 0 0 0 0 0 0 0 0 0 0 7 0 0 0 6 
 6 0 8 8 0 0 0 0 0 0 0 7 0 0 0 6 
 6 0 0 0 0 0 0 0 0 7 7 7 0 0 0 6 
 6 0 0 0 0 0 0 0 0 0 0 0 0 0 0 6 
 6 6 6 6 6 6 6 0 0 0 0 0 0 0 0 6 
 6 0 0 0 0 0 0 0 0 0 6 6 6 6 6 6 
 6 0 0 0 0 0 0 0 0 0 0 0 0 0 0 6 
 6 0 0 0 0 0 0 0 0 0 0 0 0 0 0 6 
 6 0 0 9 0 0 0 9 9 0 0 0 9 0 0 6 
 6 0 0 0 0 0 0 0 0 0 0 0 0 0 0 6 
 6 6 6 6 6 6 6 6 6 6 6 6 6 6 6 6 